--o--?-------o----------------------------------------------------------o-----------o----B----M-----------------------B-------?-----------------------?---oo-o------------------------------------oo----
-----------------------------o---------------------?----o--------EE---------------oooo-----o---------------------------------------------oo----------------------------------o--BB----------------------
-----o--BBB-------B-B------------E---------------M--------------o-----------------o-oo----o----------------ooooE-----------------BB--------------B-------------------------------------BBB--------------
-------------oo---------oo---------------?-----------------------------BBBB--------------------BB-------------------Mooo-------------------------BB-------B------------oo----------BBB----------o-------
-B----------------------------------------------oo------------------------------------------E---------------------------------------------------------BB-BBo-?--------B---------------------------------
----------------oo------------------------o--------------------------------------ooooo---------o------ooooooo------------E------E---------oBB----------------------E------o---------------M--------M----
---------------------------------------------o--------------------------------BBB------------------------------------------------------?--------Moo-----------------------------E-----------------X-----
-------------BB-------------M---?M-------------E----------------X------------M------------M-----------M------------------------------------------------------------------------------------oo----------v
--------------------------------BBB------------------BBB------------------oo---------------oo-------E-X----------oo--BB------------X----------------------------------------------------------------o--f
--BBB-----o-------------------------------------ooo-----------M---------B-?-----------X----o---------------------BBB------------------------BBBBB-o-o--------------------oo----------------------------f
-------------------------------------o---E-----------------------------------------------------------------------------------o-------------B--------BB--------------------o--------o-------------------f
-------------------T-----------------------T------------------------------------T--T--------T------------------------------T-----T-T------------------------------------------oooo---T-----------------f
------ooo----------|----BBBBB--------------|-----------------------?------------|--|--------|------------------------------|-----|-|------ooo-----------------------?----------------|-----------------f
-------------------|-----------------------|---------------------------------T--|--|--------|------------------------------|-----|-|--------------------------------T----------------|-----------------f
m------------------|-----------------------|---------------------------------|--|--|--------|------------------------------|-----|-|--------------------------------|------------T---|-----------------X
XXXXXXXXXXXXXXXXXXXXXXXXXXXXXXXXXXXXXXXXXXXXXXXXXXXXXXXXXXXXXXXXXXXXXXXXXXXXXXXXXXXXXXXXXXXXXXXXXXXXXXXXXXXXXXXXXXXXXXXXXXXXXXXXXXXXXXXXXXXXXXXXXXXXXXXXXXXXXXXXXXXXXXXXXXXXXXXXXXXXXXXXXXXXXXXXXXXXXXXX
