---------oooo-o---BoBB----------M-X------M--------------BBoo----o----------BBBBB-BBBBB-BBBBBB------------------oo--------XBBB------------X-Xoooo-----------------BBB---BB--o-BBBB-BBBB-----BBBBBo-o-----
---EBBBBBE----------------------------o----BBBB-------oo-o---------------?--o----E-o---------------------BB-o-----E--X----oE?------o--------o------BBBB?----------o-o--------EEX--o---------------------
B--ooBB--E------------------------o---E---BE-X----------------------BBBB-?-------E----------------------------EE------------------BBBBM--------M-------------------o-M------X-------------X------o------
-----------M-X-----o-BBo-----------E------?--------B?-----------BB----------X------------------oBBBBBEBBE-o----EB-------------BBB--E--M-BBBB---XBBBB------E----o--ooo--o--X-------?------BBBBB----------
-X--ooo---------E----M-------------X----X------------------------------M--B------------------BBBE-------ooBBBo------ooo------------?------M----E---oBBBB--------------oE--X----oo---------M--BBB--------
--------oo-----oooB------------o?-?-BBBBM---?-----------X---------B-BBB?----------BM-----oo---------------E--------------------o-----------------------------X-o------------oo---o---BB--------?BB?-----
-------Moo-o------X------M-----BBB------BBB-------------ooE-----------X----BBBBBBBBBBBBBB------------------------------------B--B---o-oo---o-----------------------------ooo--------------o-------------
------?---o----ooB-B?oo---------oo----------o----X-oX-------------M------------BB---------E---?---------oo---oo--X--------BBB-oo-B---BBBBBBB-----------------------------------X-------------M----oo---v
-----------------------E--------BBBBBB?----------E-----M--------BBB--o----X-Bo------------B----o------BBEB-------BBB-----------X------E-------o---------BBBoo-----BBBBE------------M-----BBBBBBB--oBB--f
-E---------B-B--------oooM---BB----?-----------------------------BBBBB----X----o----EB-----X--------?BBBB-----o-----------o--o-BBBBBB-?---oo----------------------------------------oo---M--o----------f
--E-E------B-oo----------X--?B-----------------o--------------------?M-BB---------ooB--------BBBB---------o-o---o------o?----------------------M-X-----o-----------------------------------------E-----f
------o-T--To------T--oo-------T------T--------------------T-?---------Mo-----------------------BB--BBBB--T-----------T-T-----T----o-------------?-----?------BBBBB-B-T----T-------o??------T----------f
--------|--|-------|-----------|------|--------------------|-T------------------------T-------------------|-----T-----|-|-----|----T----ooT------------T--T-----------|----|----E-T---------|----------f
--------|--|-------|----T------|------|-T------------------|-|----------------E-----T-|-------------------|-----|-----|-|----o|----|------|------------|--|-----------|----|----T-|---------|----------f
m-------|--|-------|----|-oo---|------|-|------------------|-|---M--X------ooBT-----|-|-----------------T-|-----|-----|-|-E---|----|------|------------|--|-T--X------|----|----|-|------T--|----------X
XXXXXXXXXXXXXXXXXXXXXXXXXXXXXXXXXXXXXXXXXXXXXXXXXXXXXXXXXXXXXXXXXXXXXXXXXXXXXXXXXXXXXXXXXXXXXXXXXXXXXXXXXXXXXXXXXXXXXXXXXXXXXXXXXXXXXXXXXXXXXXXXXXXXXXXXXXXXXXXXXXXXXXXXXXXXXXXXXXXXXXXXXXXXXXXXXXXXXXXX
