-----------?o---BBB-------------oo------------E--?----?-----------M----E-o---M------BBBBBBBBB---ooo--------oo-MBB---B---------------------------------?BB----------M----------X-------------o-o-ooo-----
------o----?-------------------------oo-XBB-----------M--E-----E--E----X-----M---------------oBBB-----------------------------X--X-----------ooo----M--X--------------o----------oo-----BBBX---?--------
--------------------BBBB---------------------------?--BB--------E-?BBBBB---BB--B--------------o---BB--BBB-------------------BB---oo-------o---BB-----------------------o----------------BBBBBB?EX-------
-------------E-X------oBBBBBBBo------------BBBB--oo---------oo-------?-------oo?B--------E--M-----------------------------B---------BBB-oM-------M---------o---M----------------------------------------
--BB-----B------oo---BB------X--X---------BB----------o-----------------BB----B---o-?---EBBBBBBB-------------EX-------X-------BB-----B------------X----------BoX---X-----------M---o---------------Mo---
-BBBB-BBo---------X------oo---o-Eoo------------------BB---M---X------------------BBBBoo-------MX--oo-X--?------X--------X------M-----------------------------------XBBBB--o----X--------BB--------------
------BBBE?--------------------------B-------M-o--------------------E------o----M----o---o---o------oX--?X-----------------------------------------------oo------EB-------X--------BBBE-E------M--------
BB-o--------X--------X-----Xo---------BB?-X-MBBBBMM-----M---E----o---BBB---------oo---o-----oo-------X--------oooX-E--------E------oBBBBo----X------oooo-------------------oo-----MXBBBB---E-E--X-BBB--v
---Xo------------------------BB-------------------------X--B---BBBo---E---BBBo----o-oM-o--o-------X---------E-------BBBBB-o---X-------BBooM--X---ooooo---------------?-o--ooM---X------o---------------f
---E--BBBBo------------------MBMBBBB-E-----------------------BBBBB------------------------------M-------?------------oooo-o------X-----------BBB-----E-------------?-----?------o--------E-------------f
--------oo-----Eo--------------BBBB-B-B--------o---BBBBo-BBB-E------oo-------------------B-E-------o---M------------------------------------------X-----------X----X--------ooo---------M?-------------f
--------ooBBBBBBBBB------?--------------X----T---------BBB---T-----E-X----T--------------E-M-------T------------T-----T-------T-------------oo----T-----------T----T----------M---------E-----------T--f
---T---------------------T-----------------T-|---------T-o---|-M---E---X--|-----T---T----T--oo-----|------------|-----|-------|--oT--------------o|-----------|----|--------------------------------|--f
---|-----T---------------|------------T----|-|---------|-----|-T---T------|-----|---|----|---------|---T--------|-----|-------|---|---------------|---T-------|----|-T------------------------B-----|--f
m--|-BBBB|---------------|------------|----|-|---------|-----|-|---|------|-----|---|----|---T-----|---|--------|-----|-T-----|-?-|--BBBBB--------|---|-X--?--|----|-|-------T----------T-----------|--X
XXXXXXXXXXXXXXXXXXXXXXXXXXXXXXXXXXXXXXXXXXXXXXXXXXXXXXXXXXXXXXXXXXXXXXXXXXXXXXXXXXXXXXXXXXXXXXXXXXXXXXXXXXXXXXXXXXXXXXXXXXXXXXXXXXXXXXXXXXXXXXXXXXXXXXXXXXXXXXXXXXXXXXXXXXXXXXXXXXXXXXXXXXXXXXXXXXXXXXXX
