----MBB-o-BBBBBBB-B-ooo-oBBBBBB---oooBB-B-------B-BB----------X-----------------E---------M-----------------------X------ooo-----------X?----------------X--------M-o--BBBBBEM-E-E-BBo------------------
--------------B--BBB---------o----o------oM------BBBBBBB------X---M--o--------M---------------------M-------B------------?---X-?-----oo---oo----o----BBBBM------------BBB-B----X-----------oo-----------
----------o-------?-------------X----ooo--X-----?-o-BBB--M-------------oX------oo--BBBB?---------BB---BBBBBB-BB--------------?---------o----BBB-B-oooo---BBBBB------------o-o--Eo-----E-------------M---
-------BBBB--------------------oBo------------X--------------------------o-----------oBB-----?----X------o-----------------B-----------ooo--E------------------------BBB----BBBBBBo-----E----------BB---
-------------oo------B-BBBo--E---------X-oooE------X----------o--B-BBBBoo-oo-BBBB---------o-BBBB----X------------E---------B----------------------BBBB-------------X--Moo---------ooo---X-B-BE----------
---Xoo--o---?oBBBB-BB-BBBB------------X--------------BBB-------------ooo-----M----BBBBBBo--EBBB-----MBBBBB-----EBBBBB------E------X----------------o-o----------BBBB------?oo---oo----M---o---o---------
-------BBBB-----?------------------------------------o-----BB------------X---?----Mo----------------------B--------o--B-B-BBB--oo-M-------------------o---------------o---BBB----oooo-B-------o---------
-------------oo-----------------o--------------------------EBBB--------------MB-------------------?-ooo-ooo----------------o------BBBBB------------oo------BB--------Mo--o------oo------MoBBBB-o-B-BB--v
--E-X---------X-----BBBB--BBBBBBBBBBoo----BBBBB-----------------------------------ooo------------------?-------?-M------Mooo------M----BBBBBBBB--oo--B---------M-oB-?BBBBB----------------------X------f
-----?--X--BBBB?BBo--------B-o---------?--BBBB---oo?-o---------o-------o-o----oo---------Bo----E-----BB--BB----------o-o----------------------------BBBBo?--------------------BBB------------oBBBo-----f
--------M----------BBB-------oo------------------------------------B-B--BBBBBBBEBB--X--------EoooB--------------o-ooo------------ooo-----oo-----X------B------o-----------X------oo-----o--------------f
--------T----------------T--------X-----------T---------o--------T---T-o-------?-----B-------------------------BBBB--------T--X---------T-?-T-T-BBB-----------------------T----------BBBX-----------T--f
--------|----------------|--------T-----------|---------T--------|---|-----------------------------T-----T-----------------|-o----------|---|-|----------------BBBB-------|----o-o------------------|--f
--------|------------T---|--------|-----------|---T-----|--------|---|------T---o-BT---------------|-----|-----------------|-----T------|---|-|---------------------------|--B----oT----------------|--f
m----?--|------------|-oo|--------|-----------|---|-----|--------|---|------|-----E|---------------|-----|-----------------|-X---|------|BBB|-|--T------------------------|-E---E--|----------------|--X
XXXXXXXXXXXXXXXXXXXXXXXXXXXXXXXXXXXXXXXXXXXXXXXXXXXXXXXXXXXXXXXXXXXXXXXXXXXXXXXXXXXXXXXXXXXXXXXXXXXXXXXXXXXXXXXXXXXXXXXXXXXXXXXXXXXXXXXXXXXXXXXXXXXXXXXXXXXXXXXXXXXXXXXXXXXXXXXXXXXXXXXXXXXXXXXXXXXXXXXX
