--Xo-------?-----oX-o----o-B----------?-----B---M--X------o--M---o-----M---?E------B?------------X-----B----------o---o-X-o----X---oB-----X---------------o-----?--o---oo----------------oB---o---oo--?M
----------------------------M----------B---------o--------------------------?-----------E-?--E---------------o---XXo---o------B-X-X-------------?o--oB----o----oX-o-------------------------X---------XE
-----------------o------X----oXo--o-----------o-----------B-----o-o---o-o--o--o--o---------------------o------?X------?-----------M------o-o-------o-------o------o----o----X----M----------o----B--ooXM
-o-----------Bo----o------E-----M--------M-o----------o-o-B----M-X-----o------M----------------B----E-----o--BX------oEE----o-----EM-------o-----------------------------o-------X-ME-?---------ME----?X
------B--o-----?-----------o----E---o--o-o----?-?------------------B----M-B-----o--------?----o--------o----ooo--------?-o---B--M--?-----o------?-E--------o-----o-----------oo----o--------o----o----B?
---o----o------------E--B------------o-E--o-?-M-----E-o-------------E-----o--o--------------------------o-------?-oo-------------------o--------E-oo----Bo-----------o---oX------------o-----------o--oM
---------------------------E------EM---o-o-------o-------?---------------o----o---------------E-M-E------------------o---M-Xooo-------X-----------------E-o-----Bo-----oo-------oo-M--?--------E---o--?X
-------o------o---o--------E?X----o--?----o-----B---------------------------------------o-?E-----------BE----oo---o-----------------------------oo----------o--XM-X-----E--------o--X---------oM---o--Tv
--------?---------o------oX-X-o---------X---o--------MM-----o---o-?-?-o--B-----------o?oo-BX---------------------------------M--------------?-------------o------------?---B------o-------------------?E
-EB---X-----B------------o----o--------------o-------o-----?------o-E----E-----M-M-o------------------o-----------o------------o---o---o--oo-?---------------------oE------o----E---------------------o-
---o------o-X--o-----------o--oo----E---o---o----o-E-----------oo----------o-E---------oo-------o----X----------o?---------Xoo---??---o---------------M-------------BX--o---o--------o--o---E-------o-??
------------T------T-T-T-----o------o--T---------o--------o------------?-----E-----------------T-T---------X--oT-Mo-------------------ooT-o-o-----o-----------T----------XXo--T--------?----------T----o
-T--------To|------|-|-|---o--E--------|-----------------------------o-------T------T---oE--o--|-|-?-----------|---------T---T-----o----|---o---------------Eo|-------------?-|--------------o----|----M
-|---T----|-|------|-|-|---------------|------------------T------------------|------|-T--T---o-|-|-B---------T-|--------o|---|----------|---T---------------T-|--------------o|-T------o----------|----X
m|---|----|-|------|-|-|----T----------|-----------------?|-----------T------|------|-|--|-----|-|-T---------|-|-----T---|---|-----E----|---|---------T-----|-|---------------|-|-----------------|----M
XXXXXXXXXXXXXXXXXXXXXXXXXXXXXXXXXXXXXXXXXXXXXXXXXXXXXXXXXXXXXXXXXXXXXXXXXXXXXXXXXXXXXXXXXXXXXXXXXXXXXXXXXXXXXXXXXXXXXXXXXXXXXXXXXXXXXXXXXXXXXXXXXXXXXXXXXXXXXXXXXXXXXXXXXXXXXXXXXXXXXXXXXXXXXXXXXXXXXXXX
