--------------------------------------------------------------------------------------------------------------------------------------------------------------------------------------------------------
---------------------------------------------------------------------------------------X-------------------------------------------------------------BBBBBB----X----------------------------------------
--------------------------------------------------------------------------------------------------------------------------------------------------------------------------------------------------------
----------------------------------------------------------------------------------------------------------------------------------------------------??????------------------B----M----------------------
--------------------------------------------------------------------------------------------------------------------------------------------------------------------------------------------------------
-------------------------------------------------------BBBBBBBB-----------------------------------------------------------------------------------------------------------------------------------------
---------------------------------------------------------------------------------------------------------------------------------------------------------------------------------------o----------------
-------------------------------------------------------------------------------------------------------------------------------------------------------------------------------------------------------v
------------------------------------------------------------------------------------------------------------------------------------------------------------------------------------------X-----------Bf
------------------------------------------------------------------------------------------------------------------------------------------------------------------------------X------------------------f
------------------------------------------------------------------------------------------------------------------------------------------------------?----------------------XX------------------------f
---------------------------------------------------------------------------------------B---------------------------------------------------X-----------------------T--------XXX--------???-------------f
------------------------------X-----------------------------------------------------------------------------------------------------------XX-----------------------|------?XXXX------------------------f
-----------------------------XX-X--------------------------------------------------------------------------------------------------------XXX-------T---------------|------XXXXX------------------------f
m---------------------------XXX-XX--------------------------------------------------------------------E---------------------------------XXXX-------|---------------|-----XXXXXX--E---------------------X
XXXXXXXXXXXXXXXXXXXXXXXXXXXXXXXXXXXXXXXXXXXXXXXXXXXXX--------XXXXXXXXXXXXXXXXXXXXXXXXXXXXXXXXXXXXXXXXXXXXXXXXXXXXXXXXXXXXXXXXXXXXXXXXXXXXXXXXXXXXXX|XXXXXXXXXXXXXXX|XXXXXXXXXXXXBXXXXXXXXXXXXXXXXXXXXXXX
