---------------------------------E-?---oo-------o--------o-E-------?-------o-X-----------------------------ooo-E------------------------oo------------BBBoo----o------o-M--------------M----E------oo---
---------------o----BB--------------o-oBBBo-----oo--X----------X-------------BB---------oo--EBBB---------------M---?------------BBBB--------o----------------------------------------------------BBBB---
-oo---------o---------------o--M--ooo-----------BB-oo-Moo-----BBB------------------o----?--X-----XBBBBoo-X-------o----o--------o-XBB-------M--oo------------oX---oX----------------------?--oo---E------
--------------M-o-----BBBB---B---------o--------oo----------oo-X----------o-----BB--BBBB-----------oBBBBBBX-------------------------o--BBBBB-BB--------------?---o--?BBBBBBB--?o-------------X-X--------
--oo-BBB------X--------------------E----------------o---oo--BM-------BBB------oo---------oo----oo---?---------------------------------o-------?-----------------oo--------------oo----BB----------------
----------------BB-------ooX------------oo-----BBBM----------------o---o---BBB----------oM-----BBBBB--------X--o-X-------------B-MooM-----------------o--BB-o------------------oX------?----------------
-----------------------X--------------------MBB---------BB----o---o?-----X---BBBBBBBBBBBB?-----------------------?B--o------------------oo------------B--B--BBB--oo---oo----BBB---------------X---------
--------------Bo--BB-BB--------?BBBBB--X---BBBBo----------E--o-----M------X------------?------------------------BBBBB-oo-----M--oo------BBB-----------------------M----------------------BBBBBE-ooo----v
--------BBooooM----------------?BBBBBBB-------------o------XX----------------o---------------------------M-----BBBB--?---X-X-----------M--M----?-------?-------------ooE------------------------BBBBB--f
---------M------M-----oo-o------------o------o-----------o----------------------------------BBBB-------?-----EBB-------------------oo---------BBB----------oB---------------X-----ooo------------X-----f
-----------o---------------oo-o-------------------E------------------oooo-X-B---------------BBM----o---Eo---BBBB-------?-----------Eoo--------------X------MX---------------ooE-----E-------------o----f
------T----T-o---------X--T--------------------XB-T--------T----------T-T-----T--o-----------oo----T---T---------T-----?--------T-----------------T--BBBBB--?--BBBBBBBBB---oo-T------o------o----------f
------|----|-----T-----M--|----T-------BBB----oo--|-?------|----------|-|-----|---T-T-----T-----T--|---|---------|-----Tooo-----|-----------------|------------------------T--|-----------T---T--------f
------|----|-----|-----?--|----|-----------?------|------T-|------T---|-|--E--|---|-|oo---|-----|--|--o|---------|-----|--------|-----------------|----------------------T-|--|--T---oo---|---|--------f
m-----|----|--T--|-----X--|----|-----------T------|------|-|------|---|-|--?--|---|-|-----|-----|--|---|-o-----oo|-----|-M------|--T-------------E|---------T------------|-|--|--|--MM----|--X|-T------X
XXXXXXXXXXXXXXXXXXXXXXXXXXXXXXXXXXXXXXXXXXXXXXXXXXXXXXXXXXXXXXXXXXXXXXXXXXXXXXXXXXXXXXXXXXXXXXXXXXXXXXXXXXXXXXXXXXXXXXXXXXXXXXXXXXXXXXXXXXXXXXXXXXXXXXXXXXXXXXXXXXXXXXXXXXXXXXXXXXXXXXXXXXXXXXXXXXXXXXXX
