---E-------------?-----B-----o-----o--BXoo-X---------E-B----o----------------------X-B---o--------o-------------?---------------------o--ooo?MEX--?-----o---o-M----------o------X----oo---------o-------
----o---------------------------------------o---------?-----?o---o---------BM-?--M--o--o--------------------o--------------------------B-----------o-o-----o---o-o----oo----ME--------------------------
-------------------------------------------------------o----B----o-------o--?-----------Bo-o-------------BE------------oo---o-------o--Bo--------o------M--------?o----o----o-------M--oE--------M------
--B----o----------------M-------X-------------X--M-------E--?-------o-------------------o---------B------------o----o--?M---------M-----------B-------------------o---------------E-----------------?---
--------o--X---------------o--------?-------X----X-M?-M--E------X-----------------o-M-o---------E---o-------------o-----o------o-------o-------?B-o------o-o------------M-Bo-----o--------XXo-----------
--o--------XM-o-----?-----E----o-------o---------X--------M----oM---E------------------oo----B--------------------------------o---------E-o------------o--?-----------------o------------o--o-?---------
-B------------E---oX------B-B--o------?-----------------o---EB-----M------------X--o---------?------o?--Bo----------------------o------------------------------o----------o-------o-----o----oo---------
----M-------------------o-?--------------------o----------------o----------o----X------B--M--------?----M---------------------?---o-B---------------o---M------------------o----------o----------o-----v
---B-------------------------oB--Eo-Eo---M--M---------------------------E------------o--E-?---------------o-----------o---B-------M---o-XB----------------B--------------E-B-o----?--o---E-------M?----f
-------o----oo-----------o----o--o------------------------------o---?-------o-------B----------E----------?----o-M---o----XoE--o--E----MX--o-o---o--o-B------X---o---------------------------o---------f
--o----o--------o---B---------oo----oo-----------o-------?-o-------EB--------o------M------o----o?--B---o------o----------?----o-------------------------o------o---------------o-----o-------------o--f
-----------------------E------o-----T---------o------T---o-------B------------oo--------T-B------------------o-B---o-------------------o--T------T------T--------------T-------------------o------T----f
-E-o--------M-----------------T-----|-----T----------|-o---oo----T----------------------|-E---------------T----o-------o--------o---------|------|------|----o-----o---|--------------------------|----f
-X----------o------T----------|--o--|-----|---T------|--T--------|--------------------X-|-T---------------|---------------------T------T--|------|------|----------T---|--------------------T-----|-o--f
mB--T-T--o---------|--T-------|-XT--|-----|---|-X----|-X|--T-----|------------------T-T-|-|---------T-----|--T--T---------------|------|--|------|---E--|----------|---|--------------------|-----|----X
XXXXXXXXXXXXXXXXXXXXXXXXXXXXXXXXXXXXXXXXXXXXXXXXXXXXXXXXXXXXXXXXXXXXXXXXXXXXXXXXXXXXXXXXXXXXXXXXXXXXXXXXXXXXXXXXXXXXXXXXXXXXXXXXXXXXXXXXXXXXXXXXXXXXXXXXXXXXXXXXXXXXXXXXXXXXXXXXXXXXXXXXXXXXXXXXXXXXXXXX
